100
100
PPPPPPPPPPPPPPPPPPPPPPPPPPPPPPPPPPPPPPPPPPPPPPPPPPPPPPPPPPPPPPPPPPPPPPPPPPPPPPPPPPPPPPPPPPPPPPPPPPPP
PPPPPPPPPPPPPPPPPPPPPPPPPPPPPPPPPPPPPPPPPPPPPPPPPPPPPPPPPPPPPPPPPPPPPPPPPPPPPPPPPPPPPPPPPPPPPPPPPPPP
PPPPPPPPPPPPPPPPPPPPPPPPPPPPPPPPPPPPPPPPPPPPPPPPPPPPPPPPPPPPPPPPPPPPPPPPPPPPPPPPPPPPPPPPPPPPPPPPPPPP
PPPAAASSAAASSAAAAAAAAAAAAASSAAAAAAAAAAAAAAAAAAAAAAAAAAAAAAAAAASSAAAAAAAAAAAAAAAAAAAAAAAAAASSAAAAAPPP
PPPAAASSAAAASSAAAAAAAAAAAASSAAAAAAAAAAAAAAAAAAAAAAAAAAAAAAAAAAASSAAAAAAAAAAAAAAAAAAAAAAAASSAAAAAAPPP
PPPAAAASSAASSAAAAAAAAAAAAAASSAAAAAAAAAAAAAAAAAAAAAAAAAAAAAAAAAASSAAAAAAAAAAAAAAAAAAAAAAAASSAAAAAKPPP
PPPAAAASSASSAAAAAAAAAAAAAAASSAAAAAAAAAAAAAAAAAAAAAAAAAAAAAAAAASSSSAAAAAAAAAAAAAAAAAAAAAAASSAAAAAAPPP
PPPAAAASSAASSAAAAAAAAAAAAAAASSAAAAAAAAAAAAAAAAAAAAAAAAAAAAAAAAASSAAAAAAAAAAAAAAAAAAAAAAAASSAAAAAAPPP
PPPSAASSAAASSAAAAAAAAGAAAAAASSAAAAAAAAAAAAAAAAAAAAAAAAAAAAAAAASSAAAAAAAAAAAAAAAAAAAAAAAAAASSAAAAAPPP
PPPSSAASSASSSSSSAAAAAAAAAAAAASSAAAAAAAAAAAAAAAAAAAAAAAAAAAAAAAASSAAAAAASSSSSSSSSSSSSSAAAAAASSAAAAPPP
PPPASSSSSSSSSSSSSSASASAAAAAAAASSAAAAAAAAAAAAAAAAAAAAAAAAAAAAAAAASSAAAAASSSSSSSSSSSSSSAAAAAASSAAAAPPP
PPPAASSAASSSAAAASSSSSSSSSAAAAASSAAAAAAAAAAAAAAAAAAAAAAAAAAAAAAASSAAAAAASSSSSSSSSSSSSSAAAAAASSAAAAPPP
PPPAAASSAAASSAAAAASASASSSSSAASSASAAAAAAAAAAAASSAAAAAAAAAAAAAAAAASSAAAAASSSSSSSSSSSSSSAAAAAASSAAAAPPP
PPPAAASSAASSAAAAAAAAAAAAASSSAASSSSAAAAASAAAASSSSKAAAAAAAAAAAAAASSAAAAAASSSSSSSSSSSSSSAAAAAASSAAAAPPP
PPPAASSAASSAAAAAAAAAAAAAAAASSSSSASSAAASSSSASSAASSSAAAAAAAAAAAAAASSAAAAASSSSSSSSSSSSSSAAAAASSAAAAAPPP
PPPAASSASSAAAAAAAAAAAAAAAAAASSAAAASSASSASSSSAAAASSSSSASAAAAAAAASSSSAAAASSSSSSSSSSSSSSAAAAAASSAAAAPPP
PPPAAASSSSAAAAAAAAAAAAAAASSSSSSSSSSSSSSAAASAAAAAAASSSSSSAAAAAAASSSSAAAASSSSSSSSSSSSSSAAAAASSAAAAAPPP
PPPAAAASSAAAAAAAAAAAAAAAASSSSSSSSSSSSSSAAAAAAAAAAAAAASASSSAAAAASSSSAAAASSSSSSSSSSSSSSAAAAAASSAAAAPPP
PPPAAASSSSAAAAAAAAAAAAAAASSSSSSSSSSSSSSAAAAAAAAAAAAAAAAASSSAAAAASSAAAAASSSSSSSSSSSSSSAAAAAASSAAAAPPP
PPPAAAAASSAAAAAAAAAAAAAAASSSSSSSSSSSSSSAAAAAAAAAAAAAAAAAAASSAAASSSAAAAASSSSSSSSSSSSSSAAAAAAASASAAPPP
PPPAAAASSSSAAAAGAAAAAAAAASSSSSSSSSSSSSSAAAAAAAGAAAAAAAAAAAASSASSSSSAAAASSSSSSSSSSSSSSAAAAASSSSSSAPPP
PPPAAASSSSAAAAAAAAAAAAAAASSSSSSSSSSSSSSAAAAAAAAAAAAAAAAAAAAASSSASSSSSAASSSSSSSSSSSSSSSSSSSSSASASSPPP
PPPAAAASSSSAAAAAAAAAAAAAASSSSSSSSSSSSSSAAAAAAAAAAAAAAAAAAAAAASAAASSSSSSSSSSSSSSSSSSSSSMMMMSASSAASPPP
PPPAAAASSASSAAAAAAAAAAAAASSSSSSSSSSSSSSAAAAAAAAAAAAAAAAAAAAAAAAAAASSASSSSSSSSSSSSSSSASMSSSSSSSASAPPP
PPPSSSSSSSSSSSSSSSSSAAAAASSSSSSSSSSSSSSAAAAAAAAAAAAADAAAAAAAAAAAAAASSSASSSAASSSSAASSASMSSSASSSSSAPPP
PPPMMMMMMMMMMMMMMMMSAAAAASSSSSSSSSSSSSSAAAAAAAAAAAAAAAAAAAAAASSAAASSSSAAAAAAAAAAAAAAASMSSSAASSSAAPPP
PPPMSSSSSSSSSSSSSSMSAAAAASSSSSSSSSSSSSSAAAAAAAAAAAAAAAAAAAASSSSAASSASAAAAAAAAAAAAAAAASMSSSAASSAAAPPP
PPPMSSSSSSSSSSSSSSMSAAAAASSSSSSSSSSSSSSAAAAAKKAAAAAAAAAASASSSAAAAASSAAAAAAAAAAAAAAAAASMSSSAAASSAAPPP
PPPMSSSSSSSSSSSSSSSSSSSSSSSSSSSSSSSSSSSAAAAAAAAAAAAAAAASSSSAAAAASSASSAAAAAAAAAAAAAAAASMSSSAAAASSAPPP
PPPMSSSSSSSSSSSSSSMSSSSSSSSSSSSSSSSSSSSAAAAAAAAAAAAAAASSASAAAAAAASSSSAAAAAAAAAAAAAAAASMSSSAAAAASSPPP
PPPMSSSSSSSSSSSSSSMSSSSSSSSAAAAAAAAAAAAAAAAAAAAAAAAAASSAAAAAAAAAAASSAAAAAAAAAAAAAAAAASMSSSAAAASSAPPP
PPPMSSSSSSSSSSSSSSMSSSSSSSAAAAAAAAAAAAAAAAAAAAAAAASASSAAAAAAAAAAASSSSAAAAAAAAAAAAAAAASMSSSAADASSAPPP
PPPMSSSSSSSSSSSSSSMSSSSSSSAAAAAAAAAAAAAAAAAAAAAAASSSSAAAAAAAAAAAAASSAAAAAAAAAAAAAAAAASMSSSAAAAASSPPP
PPPMSSSSSSSSSSSSSSMSSSSSSSSAAAAAAAAAAAAAAAAAAASASSASAAAAAAAAAAAAASSAAAAAAAAAAAAAAAAAASMSSSAAAAASSPPP
PPPMSSSSSSSSSSSSSSMSSSSSSSSSSSSSSSSSSSSSSSSSASSSSAAAAAAAAAAAAAAAASSAAAAAAAAAAAAAAAAAASMSSSAAAASSAPPP
PPPMSSSSSSSSSSSSSSMSSSSSMMMMMMMMMMMMMMMSSSSSSSASAAAAAAAAAAAAAAAASSSSAAAAAAAAAAAAAAAAASMSSSAAAAASSPPP
PPPMSSSSSSSSSSSSSSMSSSSSMSSSSSSSSSSSSSSMSAAASAAAAAAAAAAAAAAAAAAAAASSAAAAAAAAAAAAAAAAASMSSSAAAASSAPPP
PPPMSSSSSSSSSSSSSSMSSSSSMSSSSSSSSSSSSSSMSAAAAAAAAAAAADAAAAAAAAAAAASSAAAAAAAAAAAAAAAAASMMMMAAASSASPPP
PPPMSSSSSSSSSSSSSSMSSSSSMSSSSSSSSSSSSSSMSAAAAAAAAAAAAAAAAAAAAAAAASSAAAAAAAAAAASSAAAAASSSSSASSSSSSPPP
PPPMSSSSSSSSSSSSSSMSSSSSMSSSSSSSSSSSSSSMSAAAAAAAAAAAAAAAAAAAAAAAASSAAAAAAAAAASSSSAAAAAAAAASSSSASSPPP
PPPMMMMMMMMMMMMMMMMSSAASMSSSSSSSSSSSSSSMSAAAAAAAAAGAAAAAAAAASSAAAASSAAAASAAASSAASSAAAAAAASSAAAAAAPPP
PPPSSSSSSSSSSSSSSSSSSSASMSSSSSSSSSSSSSSMSSAAAAAAAAAAAAAAAASSSSSSASSSAAASSASSSAAAASSSSSASSSAAAAAAAPPP
PPPAAAAASSASSAAAAAAAASSSMSSSSSSSSSSSSSSMSSAAAAAAAAAAAAAAASSSSASSSSASSASSASSSAAAAAASSSSSSSSAAAAAAAPPP
PPPAAAAAAASSASAAASAAASSSMSSSSSSSSSSSSSSSSSSSSSSSSSSSSSSSSSAASAAASSSSSSSSSSSSSAAAAAAAAASASSAAAAAAAPPP
PPPSAAAAAASSSSSASSSASSASMSSSSSSSSSSSSSSSMMMMMMMMMMMMMMMMSAAAAAAAASSAASSSSASSSSSSAAAAAAAASSAAAAAAAPPP
PPPSSAAAASSSSASSSASSSAASMSSSSSSSSSSSSSSSMSSSSSSSSSSSSSSMSAAAAAAAASSAAASAAAAAASSSSAAAAAAASSAAAAAAAPPP
PPPASSSASSSSAAASAAASAAASSSSSSSSSSSSSSSSSMSSSSSSSSSSSSSSMSAAAAAAAASSAAAAAAAAAAAAASSAAAAAASSAAAAAAAPPP
PPPAASSSSASSAAAAAAAAAAASMSSSSSSSSSSSSSSSMSSSSSSSSSSSSSSSSAAAAAAAASSAAAAAAAAAAAAAASSSSAAASSAAAAAAAPPP
PPPAAAASASSAAAAAAAAAAAASMSSSSSSSSSSSSSSSMSSSSSSSSSSSSSSMSAAAAAAASSAAAAAAAAAAAAAAAASSSSAASSAAAASSAPPP
PPPAAAAAASSAAAAAAAAAAAASMSSSSSSSSSSSSSSSMSSSSSSSSSSSSSSMSAAAAAAAASSAAAAAAAAAAAAAAAAAASSASSSSASSSSPPP
PPPAAAAASSAAAAAAAAAAAAASMMMMMMMMMMMMMMMSSSSSSSSSSSSSSSSMSAAAAAAAASSAAAAAAAAAAAAAAAAAAASSSSSSSSAASPPP
PPPAAAASSSSAAAAAAAAAAAASSSSSSSSSSSSSSSSSMSSSSSSSSSSSSSSMSAAAAGAAAASSAAAAAAAAAAAAAAAAAAASSSAASAAAAPPP
PPPAAASSSSAAAAAAAAAAAAAASSAAAAAAAAAAAAASMSSSSSSSSSSSSSSMSAAAAAAAAASSAAAAAAAAAKAAAAAAAAAASSAAAAAAAPPP
PPPAAASSSSAAAAKKAAAAAAASSAAAAAAAAAAAAAASMSSSSSSSSSSSSSSMSAAAAAAAASSAAAAAAAAAAAAAAAAAAAAAAADAAAAAAPPP
PPPAASSSSAAAAAAAAAAAAASSAAAAAAAAAAAAAAASMSSSSSSSSSSSSSSMSAAAAAAASSAAAAAAAAAAAAAAAAAAAAAAAAAAAAAAAPPP
PPPASSAASSAAAAAAAAAAAAASSSSSSSSSSSSSSSSSSSSSSSSSSSSSSSSMSAAAAAASSAAAAAAAAAAAAAAAAAAAAAGAAAAAAAAAAPPP
PPPASSAAASSAAAAAAAAAAAASMMMMMMMMMMMMMMMMSSSSSSSSSSSSSSSMSAAAAAAASSAAAAAAAAAAAAAAAAAAAAAAAAAAAAAAAPPP
PPPSSAAAAASSAAAAAAAAAAASSSSSSSSSSSSSSSSMSSSSSSSSSSSSSSSMSAAAAAASSSSAAAAAAAAAAAAAAAAAAAAAAAAAAAAAAPPP
PPPASSAAASSAAAAAAAAAAAASMSSSSSSSSSSSSSSMSSSSSSSSSSSSSSSMSAAAAAAASSSSAAAAAAAAAAAAAAAAAAAAAAAKAAAAAPPP
PPPSSAAASSAAAAAAAAAAAAASMSSSSSSSSSSSSSSMSMMMMMMMMMMMMMMMSAAAAAASSAASSAAAAAAAAAAAAAAAAAAAAAAAAAAAAPPP
PPPSSAAAASSAAAAAAAAAAAASMSSSSSSSSSSSSSSMSSSSSSSSSSSSSSSSSAAAAKSSAAAASSAAAAAAAAAAAAAAAAAAAAAAAAAAAPPP
PPPSSAAAAASSAAAAAAAAAAASMSSSSSSSSSSSSSSMSAAAAAAAAAAAAAAAAAAAAAASSAASSAASSSSSSSSSSSSSSSSAAAAAAAAAAPPP
PPPAAAAAAASSAAAAAAAAAAASMSSSSSSSSSSSSSSMSAAAAAAAAAAAAAAAAAAAAAAASSSSAAASSSSSSSSSSSSSSSSAAAAAAAAAAPPP
PPPAAAAAASSAAAAKAAAAAAASMSSSSSSSSSSSSSSMSAAAAAAAAAAAAAAAAAAAAAAAASSAAAASSSSSSSSSSSSSSSSAAAAAAAAAAPPP
PPPAAAAASSAAAAAAAAAAAAASMSSSSSSSSSSSSSSMSAAAAAAAAAAAAAAAAAAAAAAASSAAAAASSSSSSSSSSSSSSSSAAAAAAAAAAPPP
PPPAAAAASSAAAAAAAAAAAAASMSSSSSSSSSSSSSSMSAAAAAAAAAAAAAAAAAAAAAAAASSAAAASSSSSSSSSSSSSSSSAAAAAAAAAAPPP
PPPAAAAASSAAAAAAAAAAAAASMSSSSSSSSSSSSSSMSAXAAAAAAAAAAAAAAAAAAAAAAASSAAASSSSSSSSSSSSSSSSAAAAAAAAAAPPP
PPPAAAAAASSAAAAAAAAAAAASMSSSSGSSSSSSSSSMSAAAAAAAAAAAAAAAAAAAAAAAASSAAAASSSSSSSSSSSSSSSSAAAAAAAAAAPPP
PPPAAAAASSAAAAAAAAAAAAASMSSSSSSSSSSSSSSSSAAAAAAAAAAAAAAAAAAAAAAASSAAAAASSSSSSSSSSSSSSSSAAAAAAAAAAPPP
PPPAAAASSAADAAAAAAAAAAASMSSSSSSSSSSSSSSMSAAAAAAAAAAAAAAAAAAAAAAAASSAAAASSSSSSSSSGSSSSSSAAAAAAAAAAPPP
PPPAAASSAAAAAAAAAAAAAAASMSSSSSSSSSSSSSSMSAAAAAAAAAAAAAAAAAAAAAAAAASSAAASSSSSSSSSSSSSSSSAAAAAAAAAAPPP
PPPAAAASSAAAAAAAAAAAAAASMMMMMMMMMMMMMMMMSAAAAAAAAAAAAAAAAAAAAAAAAAASSAASSSSSSSSSSSSSSSSAAAAAAAAAAPPP
PPPAAAASSAAAAAGAAAAAAAASSSSSSSSSSSSSSSSSSAAAAAAAAAAAAAAAAAAAAAAAAAAASSASSSSSSSSSSSSSSSSAAAAAAAAAAPPP
PPPAAAASSAAAAAAAAAAAAASSAAAAAAAAAAAAAAAAAAAAAAAAAAAAAAAAAAAAAAAAASSSSAASSSSSSSSSSSSSSSSAAAAAAAAAAPPP
PPPAAASSAAAAAAAAAAAAAASSAAAAAAAAAAAAAAAAAAAAAAAAAAAAAAAAAAAAAAAASSASSAASSSSSSSSSSSSSSSSSAAAAAAAAAPPP
PPPAAASSAAAAAAAAAAAAAAASSAAAAAAAAAAAAAAAAAAAAXAAAAAAAAAAAAAAAAAAASSSSAASSSSSSSSSSSSSSSSSSAAAAAAAAPPP
PPPAAAASSAAAAAAAAAAAAAAASSAAAAAAAAAAAAAAAAAAAAAAAAAAAAAAAAAKAAAASSASSAASSSSSSSSSSSSSSSSASSAAAAAAAPPP
PPPAAASSAAAAAAAAAAAAAAAASSAAAAAAAAAAAAAAAAAAAAAAAAAAAAAAAAAAAAAASSAASSAAAAAAAAAAAAASSAAAASSAAAAAAPPP
PPPAAASSAAAAAAAAAAAAAAASSAAAAAAAAAAAAAAAAAAAAAAAAAAAAAAAAAAAAAASSAAAASSAAAAAAAAAAASSAAAAAASASAASSPPP
PPPSAASSAAAAAAAAAAAAAAAASSAAAAAAAAAAAAAAAAAAAAAAAAAAAAAAAAAAAAAAAAAAASSAAASAAAAAAASAAAAAASSSSSSSSPPP
PPPSSASSAAAAAAAAAAAAAAAASSAAAAAAAAAAAAAAAAAAAAAAAAAAAAAAAAAAASSAAAAAASSASASAAAAAAAAAAAAASSSSASSSSPPP
PPPASASSSAAAAAAAAAAAAAAAAAAAAAAAAAAAAAAAAAAAAAAAAAASASAAAAAASSSSSSSAASSSSSSAAAAAAAAAAASSSAAAAAASSPPP
PPPAASSASSAASAAASSSSAAAAAAAAAAAAAAAAAAAAAAAAAAASASASSSAAAAASSAASSSSSSASSSSSSAAAASSSASSSSAAAAAAAAAPPP
PPPAASSASSSSSSASSSSSSASAAASSSAAAASSSSAAAAAAASAASSSASSAASSASSAAASSAASSSSASAASSSASSSSSSSAAAAAAAAAAAPPP
PPPSSSSSSASSASSSAAAASSSSSASSSSAASSSSSSAAASSASAASSSSSSASSSSSAAASSAAAAASAAAAAASSSSAAASAAAAAAAAAAAAAPPP
PPPSSSSSAAAAAASAAAAAASASSSSAASSSSASSSSAASSSASASSASSASSSAASAAAAASSAAAASSAAAAAAASAAAAAAAAAAAAAAAAAAPPP
PPPAAASSAAAAAAAAAAAAAAAAASSSSSSSSSSSSSSDSSASSSSAAAAAASAAAAAAAAASKAAASSAAAAAAAAAAAAAAAAAAAAAAAAAAAPPP
PPPAAAASSAAAAAAAAAAAAAAAASSSSSAASSAAASSSSSKSASAAAAAAAAAAAAAAAASSAAAASSAAAAAAAAAAAAAAAAAAAAAAAAAAAPPP
PPPAAASSAAAAAAAAAAAAAAAASSAAAAAAAAAAAAAASASAAAAAAAAAAAAAAAAAAASDAAAAASSAAAAAAAAAAAAAAAAAAAAAAAAAAPPP
PPPAAAASSKAAAAAAAAAAAAAAASSAAAAAAAAAAAAAAAAAAAAAAAAAAAAAAAAAAASSAAAASSAAAAAAAAAAAAAAAAAAAAAAAAAAAPPP
PPPAAAAASSAAAAAGAAAAAAAASSAAAAAAAAAAAAAAAAAAAAAKAAAAAAAAAAAAASSAAAASSAAAAAAAAAAAAAAAAAAAAAAAAAAAAPPP
PPPAAAASSAAAAAAAAAAAAAAASSAAAAAAAAAAAAAAAAAAAAAAAAAAAAAAAAAAASSAAAAASSAAAAAAAADAAAAAAAAAAAAAAAAAAAPPP
PPPAAAAASSAAAAAAAAAAAAAAASSAAAAAAAAAAAAAAAAAAAAAAAAAAAAAAAAAASSAAAAAASSAAAAAAAAAAAAAAAAAAAAAAAAAAPPP
PPPAAAASSAAAKAAAAAAAAAAAAASSAAAAAAAAAAAAGAAAAAAAAAAAAAAAAAAASSAAAAAASSAAAAAAAAAAAAAAAAAAAAAAAAAAAPPP
PPPAAASSAAAAAAAAAAAAAAAAAASSAAAAAAAAAAAAAAAAAAAAAAAAAAAAAAASSAAAAAAAASSAAAAAAAAAAAAAAAAAAAAAAAAAAPPP
PPPAAAASSAAAAAAAAAAAAAAAASSAAAAAAAAAAAAAAAAAAAAAAAAAAAAAAAASSAAAAAAAAASSAAAAAAAAAAAAAAAAAKAAAAAAAPPP
PPPAAAAASSAAAAAAAAAAAAAAAASSAAAAAAAAAAAAAAAAAAAAAAAAAAAAAAAASSAAAAAAASSAAAAAAAAAAAAAAAAAAAAAAAAAAPPP
PPPPPPPPPPPPPPPPPPPPPPPPPPPPPPPPPPPPPPPPPPPPPPPPPPPPPPPPPPPPPPPPPPPPPPPPPPPPPPPPPPPPPPPPPPPPPPPPPPPP
PPPPPPPPPPPPPPPPPPPPPPPPPPPPPPPPPPPPPPPPPPPPPPPPPPPPPPPPPPPPPPPPPPPPPPPPPPPPPPPPPPPPPPPPPPPPPPPPPPPP
PPPPPPPPPPPPPPPPPPPPPPPPPPPPPPPPPPPPPPPPPPPPPPPPPPPPPPPPPPPPPPPPPPPPPPPPPPPPPPPPPPPPPPPPPPPPPPPPPPPP
